w,w,w,w,w,w,w,w,w,w,w,w,w,w,w
w,p,p,p,b,b,b,b,b,b,b,b,b,b,w
w,p,b,p,b,b,b,b,b,b,p,b,b,b,w
w,p,b,p,b,b,p,p,p,b,p,p,p,b,w
w,p,b,p,b,b,p,b,p,b,p,p,p,b,w
w,p,b,p,b,b,p,b,p,b,p,p,p,b,w
w,p,b,p,p,b,p,b,p,b,p,p,p,b,w
w,p,b,b,p,b,p,b,p,b,p,p,p,p,w
w,p,b,b,p,b,p,b,p,b,p,p,b,p,w
w,p,b,b,p,b,p,b,p,b,p,p,b,p,w
w,p,b,b,p,b,p,b,p,b,p,p,b,p,w
w,p,b,b,p,b,p,b,p,b,p,p,b,p,w
w,p,b,b,p,p,p,b,p,p,p,p,b,p,w
w,p,b,b,b,b,b,b,b,b,b,b,b,p,w
w,s,w,w,w,w,w,w,w,w,w,w,w,e,w